R 1000 600

NO ./textures/north_texture.xpm
SO ./textures/south_texture.xpm
WE ./textures/west_texture.xpm
EA ./textures/east_texture.xpm
SF ./textures/ssssprite.xpm
ST ./textures/sprite_texture_two.xpm

F 121, 137, ,51
C 119, 181, 254

        1111111111111111111111111
        1000000000110000000000001
        1011000001110000002000001
        1001000000000000000000001
111111111011000001110000000000001
100000000011000001111011110111111
11110111111111011100000010001
11110111111111011100000010001
11000000110101011100030010001
10003000000000001100000010001
10000000000000001101010010001
11000001110101011111011110N01
11110111 1110101 101111010001
11111111 1111111 111111111111